80s

Culture Club - Karma Chameleon
The Cure - Boys don't cry
Cyndi Lauper - Girls just want to have fun
Jermaine Jackson - When the rain begins to fall
OMD - Enola Gay
Phil Collins - Against all odds
A-ha - Take on me 
F.R. David - Words
Joan Jett - I love rock'n'roll
Depeche Mode - Just can't get enough
Soft Cell - Tainted love

Eurythmics - Here comes the rain again

Joy Division - Love will tear us apart
Kim Carnes - Bette DAvis Eyes

Michael Jackson - Heal the world
Midnight Oil - Beds are burning
Prince - Kiss
Suzanne Vega - Tom's Diner
Talk Talk - Such a shame
Tears for fears - ?
Toto - Africa
USA for Africa - We are the world

Journey - Don't stop believin
INXS - Original Sin 


Duos

Michael Bublé - Something stupid
Jermaine Jackson & Pia Zadora - When the rain begins to fall
Sonny & Cher - I got you babe
Simon & Garfunkel - The sound of silence 
Renaud & Axelle Red - Manhattan Kaboul
Hélène Ségara - Vivo per lei 
David et Jonathan - 
Paroles paroles