Neil Young - Old Man 
The Kinks - Sunny afternoon
The Box Tops - The Letter
Joni Mitchell - Big Yellow Taxi
Crosby, Stills, Nash & Young - Our House
Supergrass - Alright
The Supremes - You can't hurry love
Simple Minds - Don't you forget about me
The Beach Boys - I get around
Talking Heads - Psycho killer
George Michael - Careless whisper

Leonard Cohen - So Long Marianne
Violent Femmes - Blister in the sun 
Neil Diamond - Sweet Caroline
Daft Punk - Get Lucky
The Foundations - Build me up buttercup
Venus - Beautiful days
Bee Gees - How deep is your love
Wet wet wet - Love is all aroung
The Doors - Light my fire
The Beatles - A hard day's night
The Beach Boys - Surfin USA
Tears for fears - Mad World
Suzanne Vega - Luka
Radiohead - no surprises
Donovan - Mellow yellow


Fleetwood Mac ?
The Beach Boys - Wouldn't it be nice
The Bangles - Eternal Flame
Pixies - Where is my mind
Stevie Wonder - I just called to say I love you
The Beatles - Eight days a week